Open Issue Status Values:
New                  = Issue has not had initial review yet
Accepted             = Problem reproduced / Need acknowledged
Started              = Work on this issue has begun

Closed Issue Status Values:
Fixed                = Developer made source code changes, QA should verify
Verified             = QA has verified that the fix worked
Invalid              = This was not a valid issue report
Duplicate            = This report duplicates an existing issue
WontFix              = We decided to not take action on this issue
Done                 = The requested non-coding task was completed

If an issue's status is being set to one of these values, offer to merge issues:
Duplicate

Predefined issue labels
Type-Defect          = Report of a software defect
Type-Enhancement     = Request for enhancement
Type-Task            = Work item that doesn't change the code or docs
Type-Review          = Request for a source code review
Type-Other           = Some other kind of issue
Priority-Critical    = Must resolve in the specified milestone
Priority-High        = Strongly want to resolve in the specified milestone
Priority-Medium      = Normal priority
Priority-Low         = Might slip to later milestone
OpSys-All            = Affects all operating systems
OpSys-Windows        = Affects Windows users
OpSys-Linux          = Affects Linux users
OpSys-OSX            = Affects Mac OS X users
Milestone-Release1.0 = All essential functionality working
Component-UI         = Issue relates to program UI
Component-Logic      = Issue relates to application logic
Component-Persistence = Issue relates to data storage components
Component-Scripts    = Utility and installation scripts
Component-Docs       = Issue relates to end-user documentation
Security             = Security risk to users
Performance          = Performance issue
Usability            = Affects program usability
Maintainability      = Hinders future changes


